#########################
# #         #   #       #
# ##### # # # # ### ### #
#     # # # T #   # # # #
##### ### ####### # # # #
#   #   # #         #   #
# # ### # ### ## ########
# # #   #   #     #     #
#   # ##### # ##### ### #
# # # #   #     #     # #
# ### # # # ### ### # # #
# #   # # #   #     # # #
# # ### # ### # ##### # #
# # #     # # #     # # #
# # # ### # # # ### ### #
# # #   # # # #   #   # #
# # ### # # # ### ### # #
# # #   # #     # # #   #
# # # ### ##### # # ### #
#   #   #     # # #     #
# ###### #### # # ## ####
# #       #   # #    #  #
# ### ### #S### # ##### #
#     #         #       #
#########################
