#####
# S #
## ##
# T #
#####
