==================================================.
S |           |   |                 |             |
| | .======== | | | ==. ========. .=' | .=======. |
| | |     |   | |     |     |   | |   | |   |   | |
| | | .== | ========= |===. | | '=| .=' | | | | '=|
| | | |   |       |   |   |   |   | |   | |   |   |
| | |=' .=======. '===| | '====== | | ==| |===+== |
|   |   |       |     | |         | |   | |   |   |
|===' ==| ==. ======. | |=======. | '=. | '== | ==|
| |     |   |       | | |   |   | |   |       |   |
| | .== |=. '====== | | | | | | | '=. |=====. |== |
|   |   | |     |   | | | | | |     | | |   | |   |
|===' | | |==== | .=' | | | '===. .=' | | | '=' | |
|     |   |     | |   |   |     | |   | | |     | |
| .===+===| .===' | ======| ==. '=' ==' | | .=====|
| |   |   | | |   |       |   |         | | |     |
| | | | | | | | ==+====== | .=========. | '=' ==. |
| | |   | | | |   |   |   | |         | |       | |
| | '===| | | '=. | | | ====' .====== '=========' |
|       |       |   |         |                   E
'==================================================