

==================================================.
S     |               |         | |               |
.===. '===. ======= | | .=====. | | .===. ========|
|   |     |   |     |   |     |   | |   |   |     |
| | '==== |== | .=======' ======= | '== '=. | ==. |
| |       |   | |                 |       | |   | |
| '===========| '===============. |===. .=' | .=' |
|   |         |   |             | |   | |   | |   |
|=. '=. .===. '=. |             | | ==| | ==' | ==|
| |   | |   |   | |             | |   | |     |   |
| '=. | | ===== | |             | '== | |=======. |
|   |   |       | |             |     | | |     | |
|== '===| .=====' |             | .===' | | .=. | |
|     | | |       |             | |       | | |   |
| ==. | | | | ====================' .=====' | '== |
|   |   | | |             |         | |     |     |
| | '=. | '=| ==========. | ======. | | ========. |
| |   | |   |   |       |     |   |   |         | |
| '=. '==== '===' .==== '=====' | '============ | |
|   |             |             |               | E
'==================================================

