#####
#.P.#
#...#
#...#
#...#
#...#
#...#
#...#
#...#
#...#
#...#
#...#
#...#
#...#
#...#
#...#
#...#
#...#
#...#
#...#
#...#
#...#
#...#
#...#
#...#
#...#
#...#
#...#
#...#
#...#
#...#
#...#
#.T.#
#####