########################################
#......................................#
#.####################################.#
#.#..................................#.#
#.#.################################.#.#
#.#.#..............................#.#.#
#.#.#.############################.#.#.#
#.#.#.#..........................#.#.#.#
#.#.#.#.#MMMMMMMMMMMMMMMMMMMMMM#.#.#.#.#
#.#.#.#.#.....................T#.#.#.#.#
#.#.#.#.#.GGGGGGGGGGGGGGGGGGGGG#.#.#.#.#
#.#.#.#.#........................#.#.#.#
#.#.#.#.##########################.#.#.#
#.#.#.#............................#.#.#
#.#.#.##############################.#.#
#.#.#................................#.#
#.#.##################################.#
#.#....................................#
#.######################################
#.....................................P#
########################################
