#######
#..P..#
#.....#
#.....#
#.....#
#.#MG.#
#######