#####
#P..#
#.#G#
#..M#
#..T#
#####
